WWWWWWWWWWWWWWWWWWWW
W..................W
W..................W
W..................W
W..................W
W..................W
W..................W
W..................W
W........S.........W
WWWWWWWWWWWWWWWWWWWW