WWWWWWWWWWWWWWWWWWWW
W...1..............W
W..................W
W..................W
W..................W
W..................W
W..................W
W..................W
W........S.........W
WWWWWWWWWWWWWWWWWWWW

=

{
    "1": {
        "key": "saria"
    }
}